11 11
###########
# S #G#   #
#   # ##-##
## ## |   #
#   ###-###
###-##   E#
#    # ## #
#E   #    #
##-###-##-#
#   |  #  #
###########

//　マップオブジェクトのデータ
//　種類	名前	X座標	Y座標	向き	連動元のオブジェクトの名前
lever		lever0	3	2	0
remote_door	door0	2	3	180	lever0